[MAP]::[0000]::[Beytha]
[BEGIN]
  #S#
  # #
  # #
### ######
#      @ #
#        #
#        #
# C      #
#        #
#######L##
[END]
