      ###########
      #c        #
      #   ###   #
######          #
s               #
######          #
      #   ###   #
      #         #
      ###########
